2
1
3
17
0
0
0
0
###################
#..............G..#
#......G........E.#
#................P#
#..E..............#
#..........G......#
#.................#
#.................#
###################
